#                             #                                       #
#                             #                                       #
#                             #                                       #
#                             #                                       #
#                             #                                       #
#                             #                                       #
#                             #                                       #
#                             #                                       #
#                             #                                       #
#                             #                                       #
#                             #                                       #
#                             #                                       #
#*                            #                                       L
#################             #########################################
#                                        #                            #
#                                        #                            #
#                                        #                            #
#                                        #                            #
#                                        #                            #
#                                        #                            #
#                                        #                            #
#                                        #                            #
#                                        #                            #
#                      *                 #                            #
#            ####################        #                            #
#                                        #                            #
#                                        #                            #
#                                        #                            #
#                                        #                            #
#                                        #                            #
#                                        #                            #
#                                        #                            #
#                                        #                            #
#                                        #                            #
#                                        #                            #
#                                        #                            #
#                                        #                            #
#                                        #                            #
#                                        #                            #
#                                        #                            #
#                                        #                            #
#                                        #                            #
#                                        #                            #
############       ############          #                            #
#                              #         #                            #
#                               #        #                            #
#             ####               #       #                            #
#                                 #      #                            #
#   N    M                        *#                                  #
####################################################################################################################################################################################################################################################################################