#################################################################
#                                                               #
#                                                               #
#           ###################                                 #
##                             #############################    #
#                                     #                         #
#          #                          #                         #
#                                 ######    #####################
#                                      #                        #
#   #                                  #                        #
#                                   #  #####################    #
#           #                       #  #                        #
#                                   #  #                        #
#                                   #  #   ######################
#     #                             #  #                        #
#                                   #  #                        #
#             #                     #  #####################    #
# NM                                #                           #
#                                   #*          L               #
#################################################################