








                             *
                             #
                      #
      #       #                ##              #                                 #
                               #                                                 #
#                              #         #             #               #     #   ######################
                               ##                      #                     #   #                    #
#########                      #                       #         #           #   #  #############     #
        #                      #                       #                     #   #          #   #     #
MN  S   IF                    *##                      #                     #   #          #         #
################################################################################ #######    #   #     #
                                                                               #            #L  #  #  #
                                                                               ########################